11111111111
1P00E0000C1
11111111111