11111111
100P1E01
100010C1
10000001
10001001
11111111
